code	name	abbr	short
TTT	Phenylalanine	Phe	F
TTC	Phenylalanine	Phe	F
TTA	Leucine	Leu	L
TTG	Leucine	Leu	L
CTT	Leucine	Leu	L
CTC	Leucine	Leu	L
CTA	Leucine	Leu	L
CTG	Leucine	Leu	L
ATT	Isoleucine	Ile	I
ATC	Isoleucine	Ile	I
ATA	Isoleucine	Ile	I
ATG	Methionine	Met	M
GTT	Valine	Val	V
GTC	Valine	Val	V
GTA	Valine	Val	V
GTG	Valine	Val	v
TCT	Serine	Ser	S
TCC	Serine	Ser	S
TCA	Serine	Ser	S
TCG	Serine	Ser	S
CCT	Proline	Pro	P
CCC	Proline	Pro	P
CCA	Proline	Pro	P
CCG	Proline	Pro	P
ACT	Threonine	Thr	T
ACC	Threonine	Thr	T
ACA	Threonine	Thr	T
ACG	Threonine	Thr	T
GCT	Alanine	Ala	A
GCC	Alanine	Ala	A
GCA	Alanine	Ala	A
GCG	Alanine	Ala	A
TAT	Tyrosine	Tyr	Y
TAC	Tyrosine	Tyr	Y
TAA	Stop	*	*
TAG	Stop	*	*
CAT	Histidine	His	H
CAC	Histidine	His	H
CAA	Glutamine	Gln	Q
CAG	Glutamine	Gln	Q
AAT	Asparagine	Asn	N
AAC	Asparagine	Asn	N
AAA	Lysine	Lys	K
AAG	Lysine	Lys	K
GAT	Asparticacid	Asp	D
GAC	Asparticacid	Asp	D
GAA	Glutamicacid	Glu	E
GAG	Glutamicacid	Glu	E
TGT	Cysteine	Cys	C
TGC	Cysteine	Cys	C
TGA	Stop	*	*
TGG	Tryptophan	Trp	W
CGT	Arginine	Arg	R
CGC	Arginine	Arg	R
CGA	Arginine	Arg	R
CGG	Arginine	Arg	R
AGT	Serine	Ser	S
AGC	Serine	Ser	S
AGA	Arginine	Arg	R
AGG	Arginine	Arg	R
GGT	Glycine	Gly	G
GGC	Glycine	Gly	G
GGA	Glycine	Gly	G
GGG	Glycine	Gly	G